みつきなのか	三月なのか	人名	崩壊スターレイル/プレイアブルキャラクター
みつき	三月	人名	崩壊スターレイル/プレイアブルキャラクター
たんこう	丹恒	人名	崩壊スターレイル/プレイアブルキャラクター
ひめこ	姫子	人名	崩壊スターレイル/プレイアブルキャラクター
ゔぇると	ヴェルト	人名	崩壊スターレイル/プレイアブルキャラクター
ゔぇると	ヴェルト・ヨウ	人名	崩壊スターレイル/プレイアブルキャラクター
ゔぇるとよう	ヴェルト・ヨウ	人名	崩壊スターレイル/プレイアブルキャラクター
べると	ヴェルト	人名	崩壊スターレイル/プレイアブルキャラクター
べると	ヴェルト・ヨウ	人名	崩壊スターレイル/プレイアブルキャラクター
べるとよう	ヴェルト・ヨウ	人名	崩壊スターレイル/プレイアブルキャラクター
ようおじちゃん	ヨウおじちゃん	人名	崩壊スターレイル/プレイアブルキャラクター
かふか	カフカ	人名	崩壊スターレイル/プレイアブルキャラクター
ぎんろう	銀狼	人名	崩壊スターレイル/プレイアブルキャラクター
しるばーうるふ	銀狼	人名	崩壊スターレイル/プレイアブルキャラクター
あすたー	アスター	人名	崩壊スターレイル/プレイアブルキャラクター
あすたーしょちょう	アスター所長	人名	崩壊スターレイル/プレイアブルキャラクター
あーらん	アーラン	人名	崩壊スターレイル/プレイアブルキャラクター
へるた	ヘルタ	人名	崩壊スターレイル/プレイアブルキャラクター
じぇぱーど	ジェパード	人名	崩壊スターレイル/プレイアブルキャラクター
じぇぱーど	ジェパード・ランドゥー	人名	崩壊スターレイル/プレイアブルキャラクター
じぇぱーどらんどぅー	ジェパード・ランドゥー	人名	崩壊スターレイル/プレイアブルキャラクター
ぶろーにゃ	ブローニャ	人名	崩壊スターレイル/プレイアブルキャラクター
せーばる	セーバル	人名	崩壊スターレイル/プレイアブルキャラクター
せーばる	セーバル・ランドゥー	人名	崩壊スターレイル/プレイアブルキャラクター
せーばるらんどぅー	セーバル・ランドゥー	人名	崩壊スターレイル/プレイアブルキャラクター
ぺら	ペラ	人名	崩壊スターレイル/プレイアブルキャラクター
さんぽ	サンポ	人名	崩壊スターレイル/プレイアブルキャラクター
なたーしゃ	ナターシャ	人名	崩壊スターレイル/プレイアブルキャラクター
ふっく	フック	人名	崩壊スターレイル/プレイアブルキャラクター
ぜーれ	ゼーレ	人名	崩壊スターレイル/プレイアブルキャラクター
くらーら	クラーラ	人名	崩壊スターレイル/プレイアブルキャラクター
すばろーぐ	スヴァローグ	人名	崩壊スターレイル/プレイアブルキャラクター
すゔぁろーぐ	スヴァローグ	人名	崩壊スターレイル/プレイアブルキャラクター
ていうん	停雲	人名	崩壊スターレイル/プレイアブルキャラクター
けいげん	景元	人名	崩壊スターレイル/プレイアブルキャラクター
びゃくろ	白露	人名	崩壊スターレイル/プレイアブルキャラクター
すしょう	素裳	人名	崩壊スターレイル/プレイアブルキャラクター
せいじゃく	青雀	人名	崩壊スターレイル/プレイアブルキャラクター
げんきょう	彦卿	人名	崩壊スターレイル/プレイアブルキャラクター
ぎょくう	御空	人名	崩壊スターレイル/プレイアブルキャラクター
ふげん	符玄	人名	崩壊スターレイル/プレイアブルキャラクターじげんぷーまん	次元プーマン	人名	崩壊スターレイル/敵
はんぶっしつれぎおん	反物質レギオン	人名	崩壊スターレイル/敵
いみもの	忌み者	人名	崩壊スターレイル/敵ぱむ	パム	人名	崩壊スターレイル/NPCキャラクター
やりーろ	ヤリーロⅥ	地名	崩壊スターレイル/地名
やりーろ	ヤリーロVI	地名	崩壊スターレイル/地名
やりーろしっくす	ヤリーロⅥ	地名	崩壊スターレイル/地名
やりーろしっくす	ヤリーロVI	地名	崩壊スターレイル/地名
せんしゅう	仙舟	地名	崩壊スターレイル/地名
せんしゅうらふ	仙舟「羅浮」	地名	崩壊スターレイル/地名
らふ	羅浮	地名	崩壊スターレイル/地名
せいさかい	星槎海	地名	崩壊スターレイル/地名
たいぼくし	太卜司	地名	崩壊スターレイル/地名
こうぞうし	工造司	地名	崩壊スターレイル/地名
ちょうらくてん	長楽天	地名	崩壊スターレイル/地名
ぼうきゃくのにわ	忘却の庭	地名	崩壊スターレイル/地名
もぎうちゅう	模擬宇宙	地名	崩壊スターレイル/地名ほうかいすたーれいる	崩壊スターレイル	固有名詞	崩壊スターレイル/固有名詞
ほうすた	崩スタ	固有名詞	崩壊スターレイル/固有名詞
せいきゅう	星穹	固有名詞	崩壊スターレイル/固有名詞
こうえんすい	光円錐	固有名詞	崩壊スターレイル/固有名詞
せいきゅうれっしゃ	星穹列車	固有名詞	崩壊スターレイル/固有名詞(物体)
せいさ	星槎	固有名詞	崩壊スターレイル/固有名詞(物体)
しんようぽいんと	信用ポイント	固有名詞	崩壊スターレイル/固有名詞(物体)
じげんかいおーなめんと	次元界オーナメント	固有名詞	崩壊スターレイル/固有名詞(物体)
ぎじかがく	疑似花萼	固有名詞	崩壊スターレイル/固有名詞(物体)
せいかく	星核	固有名詞	崩壊スターレイル/固有名詞(物体)
れっかい	裂界	固有名詞	崩壊スターレイル/固有名詞(概念)
きょうかんかくびーこん	共感覚ビーコン	固有名詞	崩壊スターレイル/固有名詞(概念)
きょすうのき	虚数の樹	固有名詞	崩壊スターレイル/固有名詞(概念)
せいかんりょこう	星間旅行	固有名詞	崩壊スターレイル/固有名詞(概念)
ばんぶつのがん	万物の癌	固有名詞	崩壊スターレイル/固有名詞(概念)
こはくき	琥珀紀	固有名詞	崩壊スターレイル/固有名詞(暦)
かいたくれき	開拓歴	固有名詞	崩壊スターレイル/固有名詞(暦)
じんせい	靭性	固有名詞	崩壊スターレイル/システム
げきはとっこう	撃破特効	固有名詞	崩壊スターレイル/システム
そんご	存護	固有名詞	崩壊スターレイル/運命
じゅんしゅ	巡狩	固有名詞	崩壊スターレイル/運命
きぶつ	奇物	固有名詞	崩壊スターレイル/運命
ちえん	地炎	固有名詞	崩壊スターレイル/組織
しるばーめいん	シルバーメイン	固有名詞	崩壊スターレイル/組織
しんようぽいんと	信用ポイント	固有名詞	崩壊スターレイル/素材
たびのけんぶん	旅の見聞	固有名詞	崩壊スターレイル/素材
ぼうけんきろく	冒険記録	固有名詞	崩壊スターレイル/素材
まんゆうしなん	漫遊指南	固有名詞	崩壊スターレイル/素材
いしつこうじん	遺失光塵	固有名詞	崩壊スターレイル/素材
いしつさいきん	遺失砕金	固有名詞	崩壊スターレイル/素材
いしつしょうかい	遺失晶塊	固有名詞	崩壊スターレイル/素材
いしつせいか	遺失精華	固有名詞	崩壊スターレイル/素材
しんすいのせいがいぶっしつ	深邃の星外物質	固有名詞	崩壊スターレイル/素材
きょげんちゅうてつ	虚幻鋳鉄	固有名詞	崩壊スターレイル/素材
ぼうふうのめ	暴風の眼	固有名詞	崩壊スターレイル/素材
こうおんしょうかく	恒温晶殻	固有名詞	崩壊スターレイル/素材
ぎんろうのくだけたやいば	鉄狼の砕けた刃	固有名詞	崩壊スターレイル/素材
ふぶきのつの	吹雪の角	固有名詞	崩壊スターレイル/素材
かこのかげのきんそうしょく	過去の影の金装飾	固有名詞	崩壊スターレイル/素材
くかんしょうかく	苦寒晶殻	固有名詞	崩壊スターレイル/素材
たんれんしゃのらいし	鍛錬者の雷枝	固有名詞	崩壊スターレイル/素材
うんめいのそくせき	運命の足跡	固有名詞	崩壊スターレイル/素材
しゅごしゃのひがん	守護者の悲願	固有名詞	崩壊スターレイル/素材
かいめつしゃのまつろ	壊滅者の末路	固有名詞	崩壊スターレイル/素材
しょうめつげんかく	消滅原核	固有名詞	崩壊スターレイル/素材
びげんかく	微光原核	固有名詞	崩壊スターレイル/素材
みゃくどうげんかく	脈動原核	固有名詞	崩壊スターレイル/素材
りゃくだつのほんのう	略奪の本能	固有名詞	崩壊スターレイル/素材
かいざんのやしん	改ざんの野心	固有名詞	崩壊スターレイル/素材
ふみにじるいし	踏みにじる意志	固有名詞	崩壊スターレイル/素材
しるばーめいんこう	シルバーメイン釦	固有名詞	崩壊スターレイル/素材
しるばーめいんきしょう	シルバーメイン記章	固有名詞	崩壊スターレイル/素材
しるばーめいんくんしょう	シルバーメイン勲章	固有名詞	崩壊スターレイル/素材
こだいぱーつ	古代パーツ	固有名詞	崩壊スターレイル/素材
こだいしゃふと	古代シャフト	固有名詞	崩壊スターレイル/素材
こだいえんじん	古代エンジン	固有名詞	崩壊スターレイル/素材
えいじゅのほうが	永寿の萌芽	固有名詞	崩壊スターレイル/素材
えいじゅのてんか	永寿の天華	固有名詞	崩壊スターレイル/素材
えいじゅのえいし	永寿の栄枝	固有名詞	崩壊スターレイル/素材
こうぞうきかん	工造機関	固有名詞	崩壊スターレイル/素材
こうぞうねりん	工造迴輪	固有名詞	崩壊スターレイル/素材
こうぞうこんしん	工造渾心	固有名詞	崩壊スターレイル/素材
はさいのはぎれ	破砕の刃切	固有名詞	崩壊スターレイル/素材
むしょうのはぎれ	無生の刃切	固有名詞	崩壊スターレイル/素材
じょうかいのはぎれ	浄世の刃切	固有名詞	崩壊スターレイル/素材
しゅじゅうのや	狩獣の矢	固有名詞	崩壊スターレイル/素材
とまのや	屠魔の矢	固有名詞	崩壊スターレイル/素材
ちくせいのや	逐星の矢	固有名詞	崩壊スターレイル/素材
ちゃくそうのかぎ	着想のカギ	固有名詞	崩壊スターレイル/素材
けいはつのかぎ	啓発のカギ	固有名詞	崩壊スターレイル/素材
えいちのかぎ	叡智のカギ	固有名詞	崩壊スターレイル/素材
ちょうわのはーもにー	調和のハーモニー	固有名詞	崩壊スターレイル/素材
かぞくさんか	家族賛歌	固有名詞	崩壊スターレイル/素材
ぐんせいのがくしょう	群星の楽章	固有名詞	崩壊スターレイル/素材
あんたんのこくよう	黯淡の黒曜	固有名詞	崩壊スターレイル/素材
こくうのこくよう	虚空の黒曜	固有名詞	崩壊スターレイル/素材
ちんりんのこくよう	沈淪の黒曜	固有名詞	崩壊スターレイル/素材
せいどうのしゅうちゃく	青銅の執着	固有名詞	崩壊スターレイル/素材
かんてつのちかい	寒鉄の誓い	固有名詞	崩壊スターレイル/素材
こはくのけんしゅ	琥珀の堅守	固有名詞	崩壊スターレイル/素材
ほうじょうのたね	豊穣の種	固有名詞	崩壊スターレイル/素材
せいめいのめ	生命の芽	固有名詞	崩壊スターレイル/素材
えいきゅうのはな	永久の花	固有名詞	崩壊スターレイル/素材
きんこうのしれん	均衡の試練	固有名詞	崩壊スターレイル/素材
うちゅうふういんすてーしょん	宇宙封印ステーション	固有名詞	崩壊スターレイル/次元界オーナメント
おいぬもののせんしゅう	老いぬ者の仙舟	固有名詞	崩壊スターレイル/次元界オーナメント
はんぎんがしょうじがいしゃ	汎銀河商事会社	固有名詞	崩壊スターレイル/次元界オーナメント
はんぎんがしょうじかいしゃ	汎銀河商事会社	固有名詞	崩壊スターレイル/次元界オーナメント
けんそうしゃのべろぶるぐ	建創者のベロブルグ	固有名詞	崩壊スターレイル/次元界オーナメント
てんたいかいさきかん	天体階差機関	固有名詞	崩壊スターレイル/次元界オーナメント
じてんがとまったさるそっと	自転がとまったサルソット	固有名詞	崩壊スターレイル/次元界オーナメント
とうぞくこうこくたりあ	盗賊公国タリア	固有名詞	崩壊スターレイル/次元界オーナメント
せいめいのうぇんわーく	生命のウェンワーク	固有名詞	崩壊スターレイル/次元界オーナメント
かいおくのつぼみ	回憶の蕾	固有名詞	崩壊スターレイル/疑似花萼
えーてるのつぼみ	エーテルの蕾	固有名詞	崩壊スターレイル/疑似花萼
ひぞうのつぼみ	秘蔵の蕾	固有名詞	崩壊スターレイル/疑似花萼